#########################
#                       #                          
#  ....                 #
#  .  .                 #
#  .  .                 #
#  ....                 #
#                       #
#                       #
#                       #
#                       #
#########################

SCREEN => LAYER => BOX => WIDGET 




